NO textures/no_wall.png
SO textures/so_wall.png
WE textures/we_wall.png
EA textures/ea_wall.png

F 000241,100,0
C 225,30,0


    11111111
    10011111
    10111111
11111001
10000001
10S 0001
11111111