
NO textures/no_wall.png
SO textures/so_wall.png
WE textures/we_wall.png
EA textures/ea_wall.png

F 0, 0, 255
C 225,30,0

1111111111111111111111111
1000000000110000000000001
1011000001110000000000001
1001000000000000000000001     1111
1111111110110000011100001111111001
1000000000110000011101100000111111
11110111111111011100000010001
11110111111111011101010010001
11000000110101011100000010001
1000000000000000110000001W001
10000000000000001101010010001
1100000111010101111101111011111
111101111110101101111010001
111111111111111111111111111