NO textures/no_wall.png
SO textures/so_wall.png
WE textures/we_wall.png
EA textures/ea_wall.png

F 000255, 255, 255
C 220,30,0 

111111111
100N00001
100000001
100000001
100000001
100000001
100000001
100000001
100000001
100000001
100000001
100000001
100S00001
100000001
100000001
100000001
111111111