NO textures/no_wall.png
SO textures/so_wall.png
WE textures/we_wall.png
EA textures/ea_wall.png

F 255, 255, 0
C 0, 0, 0

111111111111
1         11
1       0001
1000N0000001
1000000 0011
111111111111
11         1
111111111111