NO textures/no_wall.png
SO textures/so_wall.png
WE textures/we_wall.png
EA textures/ea_wall.png

F 000241,100,0
C 225,30,0


      11111111
      10000001
      10000001     
11111110000001111111111
10000000000000000000001
100S0000000000000000001
11111110000001111111111
      10000001
      10000001
      11111111