NO textures/no_wall.png
SO textures/so_wall.png
WE textures/we_wall.png
EA textures/ea_wall.png

F 220,30,0
C 000255, 255, 255


    1111 111
    10011111
    10111111
11111001
10S 0001
10000001
11111111