NO textures/no_wall.png
SO textures/so_wall.png
WE textures/we_wall.png
EA textures/ea_wall.png

F 240, 192, 100
C 204,255,229

111111111
100000001
100000001
100000W01
100000001
100010001
100000001
100000001
100000001
100000001
100000001
100000001
111111111