
NO			 ./no_wall.png
SO		   ./path_to_the_south_texture.png
WE  ./path_to_the_west_texture.png
EA 			./path_to_the_east_texture.png

F 0000241,100,0
C 225,30,0

111111111
100000111
1000001
1000001
100000111
100000001
111111111