NO ./no_wall.png
SO ./path_to_the_south_texture.png
WE ./path_to_the_west_texture.png
EA ./path_to_the_east_texture.png

F 000241,100,0
C 225,30,0

  111111
  100S01
10100001
10000001
11111111