NO textures/no_wall.png
SO textures/so_wall.png
WE textures/we_wall.png
EA textures/ea_wall.png

F 000241,100,0
C 225,30,0

11111111
10000001
10000001
10000001
10000001
10000001
100001
10S001
100001
100001
111111