NO textures/no_wall.png
SO textures/so_wall.png
WE textures/we_wall.png
EA textures/ea_wall.png

F 000241,100,0
C 225,30,0

111111
100001
100001
100000
100001
100001
10000111
10S00001
10000001
10000001
11111111