NO textures/no_wall.png
SO textures/so_wall.png
WE textures/we_wall.png
EA textures/ea_wall.png

F 100,10  ,2
C 225,30,100


11111111
10000001
10000S01
10000001
10000001
10000001
10000001
10000001
10000001
10000001
10000001
10000001
11111111