111111111
100S00001
100000001
111111111


NO textures/no_wall.png
SO textures/so_wall.png
WE textures/we_wall.png
EA textures/ea_wall.png

F 241,100,0
C 225,30,0
